ships:5
QABCDEFGHIJ
1-11-4-----
2-22-4-----
3----4-----
4----4-----
5-55555----
6----------
7----------
8----------
9----------
1333-------